%%%%%%%%%%%%%%%%%%
%................%
%....%%%%%%%%....%
%....%G....G%....%
%..%.%..%%..%.%..%
%..%.%..%%..%.%..%
%..%.%......%.%..%
%..%P%..oo..%.%..%
%.o%..........%o.%
%.....%%%%%%.....%
%...%.%....%.%...%
%.%.%o%....%o%.%.%
%.%.%.%.oo.%.%.%.%
%.%.%.%....%.%.%.%
%.%.%........%.%.%
%.%.....oo.....%.%
%................%
%%%%%%%%%%%%%%%%%%