%%%%%%%%%%%%%%%%%%%%
%..................%
%....%%%%..%%%%....%
%...............G..%
%..G..%%%..%%%.....%
%....%........%....%
%....%.o....o.%....%
%.%%%%%%%..%%%%%%%.%
%...o...%..%...o...%
%.....P.%..%.......%
%.%%%%%%%..%%%%%%%.%
%....%.o....o.%....%
%...o%........%o...%
%.....%%%..%%%.....%
%...G..........G...%
%....%%%%..%%%%....%
%..........G.......%
%%%%%%%%%%%%%%%%%%%%