%%%%%%%%%%%%%%%%
%..............%
%..............%
%..............%
%..............%
%..............%
%..............%
%..G%%....%%G..%
%.%%%%%..%%%%%.%
%.%%%......%%%.%
%.%%%......%%%.%
%..............%
%....P.........%
%..............%
%%%%%%%%%%%%%%%%