%%%%%%%%%%%%%%%%
%...%%%..%%%...%
%..............%
%..............%
%...%......%...%
%%..%......%..%%
%%.%P%....%%%.%%
%%............%%
%%%%%%....%%%%%%
%..............%
%.....%..%.....%
%.....%..%.....%
%...%%G..G%%...%
%..............%
%..............%
%%%%%%%%%%%%%%%%