%%%%%%%%%%%%%%%%%%%
%...%.........%...%
%.%%.%%..P..%%.%%.%
%.................%
%.%%...........%%.%
%..%...........%..%
%.G%%%.%...%.%%%G.%
%..%.%%%...%%%.%..%
%..%...........%..%
%%%%%%%%%%%%%%%%%%%