%%%%%%%%%%%%%%%%%%%%
%..................%
%.o%%%%%....%%%%%o.%
%...o..........o...%
%..%.%.%....%.%.%..%
%.o%.%.%....%.%.%o.%
%..%.%.%....%.%.%..%
%..%.%..%..%..%.%..%
%..%....%..%....%..%
%..%....%..%....%..%
%..%....%..%....%..%
%..%.o..%..%..o.%..%
%......P...........%
%.....G......G.....%
%.G..............G.%
%%%%%%%%%%%%%%%%%%%%