%%%%%%%%%%%%%%%%%%%%
%.......%..%.......%
%....oo%%..%%oo....%
%...%o%%....%%o%...%
%..%%..........%%..%
%.%%.o%%%..%%%o.%%.%
%.%..............%.%
%.%..............%.%
%.%P%%%%....%%%%.%.%
%.%.%..........%.%.%
%.%.%..%....%..%.%.%
%.%.%..%....%..%.%.%
%...%...%%%%...%...%
%...%%........%%...%
%...%%%......%%%...%
%.%..%G%%%%%%G%..%.%
%.%..............%.%
%.%%%%%%....%%%%%%.%
%.%%%%%%....%%%%%%.%
%%%%%%%%%%%%%%%%%%%%