%%%%%%%%%%%%%%%%%%%%
%..................%
%.%..............%.%
%.%%.oo.%..%.oo.%%.%
%.%%G...%..%...G%%.%
%.%%.o........o.%%.%
%.%%%%%%%..%%%%%%%.%
%.%%%%%%%..%%%%%%%.%
%.%%............%%.%
%.%....P.........%.%
%..................%
%...%.........%....%
%...%.........%....%
%...%..o....o.%....%
%..................%
%..................%
%%%%%%%%%%%%%%%%%%%%