%%%%%%%%%%%%%%%%%%%%
%..................%
%..................%
%..................%
%...............P..%
%.o.oG..%..%..Go.o.%
%.......%..%.......%
%....%%%%..%%%%....%
%.......%..%.......%
%.%%%%%......%%%%%.%
%..................%
%.......%..%.......%
%.......%..%.......%
%...%o%%%..%%%o%...%
%......%%..%%......%
%..o...%%..%%...o..%
%..%%%%%%..%%%%%%..%
%..G............G..%
%..................%
%%%%%%%%%%%%%%%%%%%%
