%%%%%%%%%%%%%%%%%%%%
%..................%
%...%..........%...%
%...%..........%...%
%...%......%...%...%
%..........%.......%
%...%...%...%...%..%
%........o.........%
%...%...%...%...%..%
%..........%.......%
%...%......%......G%
%...%......%......G%
%...%..........%...%
%...%..........%...%
%...%..........%...%
%...%......%...%...%
%..........%.......%
%......G......G....%
%%%%%%%%%%%%%%%%%%%%
