%%%%%%%%%%%%%%%%%%%%
%..................%
%....%.o....o.%....%
%....%........%....%
%....o........o....%
%....%%......%%....%
%...%%%%....%%%%...%
%..%%%%......%%%%..%
%..................%
%...%%%G....G%%%...%
%..................%
%..G%%%%%..%%%%%G..%
%...o..........o...%
%...P..........%...%
%...%.o......o.%...%
%...%..........%...%
%..%%%%%%..%%%%%%..%
%..................%
%..................%
%%%%%%%%%%%%%%%%%%%%