%%%%%%%%%%%%%%%%%%%%
%..................%
%....o........o....%
%.....%....%.......%
%.....%....%.......%
%.%...%....%.....%.%
%.%......o.......%.%
%.%..............%.%
%.%..G.%....%.G..%.%
%....%.%%..%%.%....%
%..o...%....%...o..%
%.G.%%%%%..%%%%%.G.%
%...%..%....%..%...%
%...%..%....%..%...%
%...%..P.......%...%
%...%..........%...%
%......o....o......%
%.%o%%%......%%%o%.%
%...%%%%%..%%%%%...%
%%%%%%%%%%%%%%%%%%%%