%%%%%%%%%%%%%%%%
%..............%
%...%......%...%
%...%.%..%.%...%
%...%......%...%
%o............o%
%..............%
%....P.........%
%...%%%..%%%...%
%..............%
%.G..o....o..G.%
%..............%
%%%..........%%%
%.....%..%.....%
%.....%..%.....%
%%%%%%%%%%%%%%%%