%%%%%%%%%%%%%%%%%%
%................%
%................%
%.%%%%%%..%%%%%%.%
%.%............%.%
%.%%%%G%..%G%%%%.%
%.%.%%%%..%%%%.%.%
%.P..............%
%................%
%%%%%%%%%%%%%%%%%%