%%%%%%%%%%%%
%.%%%%%%%%%%
%......G..%%
%.%..%....%%
%.P%%%%%..%%
%.%..%.....%
%.%..%.....%
%.....%...G%
%.....%....%
%...%%%%%..%
%...%%%%%%%%
%%%%%%%%%%%%