%%%%%%%%%%%%%%%%%%
%................%
%................%
%................%
%.G%%%%%..%%%%%G.%
%......%..%......%
%.%..%.%..%.%..%.%
%.%.P%.%..%.%..%.%
%.%..%.%..%.%..%.%
%%%%%%%%%%%%%%%%%%