%%%%%%%%%%%%%%%%%%%%
%G.....o.%%.o.....G%
%........%%........%
%........%%........%
%.....%..%%..%.....%
%.....%..%%..%.....%
%.....%..%%..%...P.%
%%....%......%....%%
%%....%......%....%%
%%....%.G..G.%....%%
%%................%%
%%%%%%..o..o..%%%%%%
%..................%
%..................%
%..................%
%%................%%
%%................%%
%%....oo....oo....%%
%%...%%%....%%%...%%
%%%%%%%%%%%%%%%%%%%%