%%%%%%%%%%%%%%%%
%..............%
%..............%
%..............%
%..............%
%..............%
%..............%
%...G......G...%
%%%%%......%%%%%
%%...o....o...%%
%%..%%....%%..%%
%%..%%....%%..%%
%%.Po%....%o..%%
%...%%....%%...%
%.%%%%%..%%%%%.%
%%%%%%%%%%%%%%%%