%%%%%%%%%%%%%%%%%%%%
%...o..........o...%
%..................%
%%................%%
%%%.%..........%.%%%
%%P.%..........%.%%%
%%%%%%%......%%%%%%%
%.%.%..........%.%.%
%...%..........%...%
%..................%
%.G..............G.%
%o.%.%........%.%.o%
%..%.%........%.%..%
%%%%%%%......%%%%%%%
%..................%
%..%o..o....o..o%..%
%%%%%%%%%%%%%%%%%%%%