%%%%%%%%%%
%G......G%
%........%
%........%
%........%
%........%
%........%
%P%%..%%%%
%%%....%%%
%%%%%%%%%%