%%%%%%%%%%%%%%%%
%..............%
%.P............%
%.G%%%%..%%%%G.%
%.%%%%....%%%%.%
%..............%
%..............%
%%%%%%%%%%%%%%%%