%%%%%%%%%%%%%%%%%%
%................%
%.%............%.%
%.%..G......G..%.%
%.%%..........%%.%
%.%%..........%%.%
%.%%%..%..%..%%%.%
%.P.%..%..%..%...%
%...%..%..%..%...%
%%%%%%%%%%%%%%%%%%