%%%%%%%%%%%%%%%%
%..............%
%.P.G......G...%
%..............%
%.....%..%.....%
%.....%..%.....%
%..%.%....%.%..%
%..%.%....%.%..%
%..%.%....%.%..%
%..%.%....%.%..%
%..%.%....%.%..%
%.%%%%%..%%%%%.%
%..%........%..%
%..............%
%%%%%%%%%%%%%%%%