%%%%%%%%%%%%%%%%%%%
%G.       G   ....%
%.% % %%%%%% %.%%.%
%.%o. %   o. %.o%.%
%.%%%.%  %%% %..%.%
%.....  P    %..%G%
%%%%%%%%%%%%%%%%%%%%
